
WE gg.xpm
NO floor.xpm

 
F 76,83,91
C 225,30,08

SO gg.xpm
EA gg.xpm

11111111111111111111111111111111111111
111000000010000000000000000000000000011
111000000000000000000000000000000000011
   11111111000010000000000000000000000111
111000001000000000000000000000000000011
11110000000000100000000000000000000001111111111111111
11100000000011100000000000000000000E1000000000011
11110000000001100000000000000000000001111111111
111000000000010000000000000000000000011
11111111111111111111111111111111111111