
WE mucha_brown.xpm
NO mucha_white.xpm



SO all.xpm
EA mucha_red.xpm

F 184,113,39
C 51,198,22

111111111111111111111111111   
100000001100000000000000001
101100011100000000000010001
100100000000000000000010001
101100011100000000000010001
100000001100000111011110001
111101111111011100000010001
111101111111011101010010001
110000110101011100000010001
100000000000001100000010001
100000000000001101010010001
110000110101000000000000001
111101110101000000000000001
100000001100000100000010001
100000000000001010000101001
100000001000010001010001001
100000001101000000N00000001
100000000100000001010000001
111111111111111111111111111
111111111111111111111111111