111111111111111
10001000P000011
    100000000000011
111111100000001
100010000000001
    100000000000001
100000000000001
100000000000001
100000000000001
111111111111111