1111111111111111111111111111111111111111111111
10001000P0111111111000000000100000001000P00001
1000000000111111111000000000100000000000000001
1111111000111111111000000000100001111110000001
1000100000111111111000000000100000001000000001
1000000000111111111000000000100000000000000001
1000000000111111111000000000100000000000000001
1000000000111111111000000000100000000000000001
1000000000111111111000000000100000000000000001
1111111111111111111111111111111111111111111111