11111111111111111111111111111111111111
11100000001000P000011
111000000000000000011
111000011111100000011
111000000010000000011
111000000000000000011
111000000000000000011
111000000000000000011
111000000000000000011
11111111111111111111111111111111111111