111111111111111111111111111111111111111111
10001000P0000000001000P0000000001000P00001
100000000000000000000000000000000000000001
111111100000000111111000000001111110000001
100010000000000000100000000000001000000001
100000000000000000000000000000000000000001
100000000000000000000000000000000000000001
100000000000000000000000000000000000000001
100000000000000000000000000000000000000001
111111111111111111111111111111111111111111