EA mucha_red.xpm
F 184,113,39     
WE mucha_red.xpm









C 51,198,22
NO mucha_red.xpm
     
SO mucha_red.xpm

11111111                                                                        
11111111
11111111
11111111
11111111
11111111
11111111
11111111
 
11111111
 
 
11111111
11111111
11111111
11111111
  
11111111
11111111
11111111
11111111
    
11111111
11111111
11111111
11111111
    
11111111
11111111
11111111
    1N1
11111111