11111111111111111111111111111111111111
11100000001000P000000000000000000000011
111000000000000000000000000000000000011
111000011111100000000000000000000000011
111000000010000000000000000000000000011
111000000000000000000000000000000000011
111000000000000000000000000000000000011
111000000000000000000000000000000000011
111000000000000000000000000000000000011
11111111111111111111111111111111111111