EA mucha_white.xpm
WE mucha_red.xpm


F 220,100,0
C 225,30,0


NO mucha_brown.xpm
SO all.xpm

1111111111
1000000001
1000000001
1000N00001
1000000001
1111111111