
EA mucha_white.xpm     
WE mucha_red.xpm

F 220,100,250
C 225,30,0


NO mucha_brown.xpm
SO all.xpm

11111111111111111111111111111111111111111111111111111111111111111
1000000000000000000000000000000000000000000000000000000001
1000100000001000000010000000100000001000000010000000100001
10010000000100000000000000000E0000000000000000000000000001
10001000000010000000100000001000000010000000100000001000001
11111111111111111111111111111111111111111111111111111111111