EA mucha_white.xpm
WE mucha_red.xpm


F 220,100,0
C 225,30,0


NO mucha_brown.xpm
SO all.xpm


        1111111111111111111111111
        1000000000110000000000001
        1011000001110000000000001
        1001000000000000000000001
111111111011000001110000000000001
100000000011000001110111111111111
11110111111111011100000010001
11110111111111011101010010001
11000000110101011100000010001
1000000000000000110000001000111
10000000000000000000000010000001
110000011101010111110010000W0011
11110111 1110101 101111010101111
11111111 1111111 111111111111